
NO ./textures/arcade/arcade_1.xpm  
SO ./textures/arcade/arcade_2.xpm 
WE ./textures/arcade/arcade_3.xpm
EA ./textures/arcade/arcade_4.xpm 

C 245, 245,                                          245 
F 10, 10, 10 

11111
10N00
11111
