
NO ./textures/1.xpm  
SO ./textures/2.xpm 
WE ./textures/3.xpm
EA ./textures/4.xpm 

C 16, 208,                                          241 
F  +,  +,      + 

111111111111111111111111111
100001000001 10000000001
101100000001100000011000001
100100010000000010100000000111
111111111111111111111111111111
  
111111111111111111111111111111
100000000000000000100000010001
100000000000000000010100010001
100000000000010000000000000001   
1000000000000N0000010000000001    
100000001000000000101010000001   
111000111111111111111111100001
111111110000000000000000111111
111111111111111111111111111111
 
