
NO ./textures/1.xpm  
SO ./textures/2.xpm 
WE ./textures/3.xpm
EA ./textures/4.xpm 

C 16, 208,                                          241 
F  61,  214,       31

1111111111111111111111111111
1000000000000000000000000001
1000111111111111111111100001
10000000000001 1000000000001
1000000000000010000000000N01 
1111111111111111111111111111
     
1111111111111111111111111111
1000000001000000000000000001
1111111111111111111111111111
