NO ./textures/1.xpm  
SO ./textures/2.xpm 
WE ./textures/3.xpm
EA ./textures/4.xpm 

F     250,  100,        0
C 250,1,                                          0 

1111111
1100001
10N1001
1000001
1001001
1000011
1111111
