NO ./textures/1.xmp  
SO ./textures/1.xmp 
WE ./textures/1.xmp
EA ./textures/2.xmp

F     250,  100,        0
C 250,1,                                          0

1111111111111
1000000000001
100000N00111
1000000000001
1111111111111
