NO ./textures/1.xmp  
SO ./textures/1.xmp 
WE ./textures/1.xmp
EA ./textures/2.xmp

F     250,  100,        0
C 250,1,                                          0

11111111
10000001
10010111
10000001
100N0001
10010001
1000001
1111111
