NO ./textures/1.xpm  
SO ./textures/2.xpm 
WE ./textures/3.xpm
EA ./textures/4.xpm 

F     61,  43,       31 
C 116, 208,                                          241 

1111111111111111
1000000000000001
1000000000000001
100000W000000001
1000000000000001
1000000000000001
1000000000000001
1000000000000001
1000000000010001
1000000000000001
1000000100000001
1000000000000001
1000000000000001
1000100000000001
1000000000000001
1000000000000001
1000000000000001
1000000000000001
1000000000000001
1000000000000001
1111111111111111


