NO ./textures/1.xmp  
SO ./textures/1.xmp 
WE ./textures/1.xmp
EA ./textures/2.xmp

F     250,  100,        0
C 250,1,                                          0

111111111
    100000N01
111111111
