
NO ./textures/garden/garden_1.xpm  
SO ./textures/garden/garden_2.xpm 
WE ./textures/garden/garden_3.xpm
EA ./textures/garden/garden_4.xpm 

C 16, 208,                                          241 
F 30, 60, 30 
1111111111111111111111111111
1000000000000000000000001
1000111111111111111111101111
1000000000001N10000000000001
1000000000000010000000000001 
1111111111111111111111111111 
1111111111111111111111111111
1000000001000000000000000001
1111111111111111111111111111
