NO ./textures/north.xpm  
SO ./textures/south.xpm 
WE ./textures/west.xpm
EA ./textures/east.xpm 

C 0,0,255 
F 255,0,0

            111111111111111111111111
            100000001000000001001001
            111001111001001001001001
            100001000001001000000001
111111111111111001111001111001100001
100000000000000000100000100100111111
1001001111001111111111001001111
1001000001000001000001000000001111111111111
1111111001001001111000011111000000000000001
1111111101111111111101111111111111111111111
       101         101           1000001
1111111101111111111101111111111  1000001
1000001001001001000000000001011  1000001
1001001001001111001111001111111  1000001
100100100000000000000000100000111111111111111111111111111111
11111111001001001111001001111001110E011111111111111111111111
       10010000010010010000010000001011111111111111111111111
111111111110011110010011110000010000011111111111111111111111
100100100000000000100100100100111111111111111111111111111111
1001111001111001111111111111111
1000000000001001
1111001001001111  1111111111111111111111
1000001001000001  1000000000000000000001
1111111111111111  1111111111111111111111
 
1111111111111111111111111111111111
1000000000000000000000000000000001
1111111111111111111111111111111111
