
NO ./textures/garden/garden_1.xpm  
SO ./textures/garden/garden_2.xpm 
WE ./textures/garden/garden_3.xpm
EA ./textures/garden/garden_4.xpm 

C 16, 208,                                          241 
F 30, 60, 30 

01111
10N01
11111
